type octile
height 7
width 9
map
.........
.@.@.@.@.
.@.@.@.@.
.........
.@.@.@.@.
.@.@.@.@.
.........
